باادب		ادب
بااخلاق		اخلاق
باکردار		کردار
باعزت		عزت
بامراد		مراد
بےادب		ادب
بےنصیب		نصیب
بےمروت		مروت
بےعزت		عزت
پابند		بند
پامال		مال
پانچ		پانچ
تہخانہ		خانہ
تہبند		بند
نامراد		مراد
نامرد		مرد
نافرمان		فرمان
ناامید		امید
نونہار		نونہار
نوجوان		نوجوان
نونہال		نونہال
پرکیف		کیف
پردرد		درد
پرنور		نور
پرجوش		جوش
پرزور		زور
بدنصیب		نصیب
بدنام		نام
بدصورت		صورت
بدتہذیب		تہذیب
بدگمان		گمان
انجان		جان
انتھک		تھک
انگنت		گنت
انمول		مول
چوراہا		راہ
چوہٹہ		ہٹہ
چومکھی		مکھی
چوکور		کور
چوگنا		گنا
لڑکیاں		لڑک
ٹاکیاں		ٹاک
ٹافیاں		ٹاف
خاموشیاں		خاموش
بسیں		بس
کریں		کر
رویں		رو
دھویں		دھو
سویں		سو
دسویں		دسو
کرنا		کر
بھرنا		بھر
سڑنا		سڑ
جاگنا		جاگ
ڈالنا		ڈال
رشتےدار		رشتے
دانےدار		دانے
سمجھدار		سمجھ
خبردار		خبر
دولتمند		دولت
عزتمند		عزت
دغاباز		دغا
دھوکاباز		دھوکا
جانباز		جان
ہواباز		ہوا
کبوترباز		کبوتر
دلبر		دل
پیغمبر		پیغمام
راہبر		راہ
خوردبین		خورد
بدبین		بد
مبین		مبین
باریکبین		باریک
دوربین		دور
اشکبار		اشک
شعلہبار		شعلہ
مشکبار		مشک
عطربار		عطر
ہنسایا		ہنسا
سویا		سو
کھایا		کھا
رویا		رو
گرجتا		گرج
گرتا		گر
جاتا		جا
ہونگے		ہو
آئیںگے		آئیں
کھیلیںگے		کھیلیں
کرتے		کر
جاتے		جا